NO ./textures/walls/North_wall_temp.xpm
SO ./textures/walls/South_wall_temp.xpm
WE ./textures/walls/West_wall_temp.xpm
EA ./textures/walls/East_wall_temp.xpm

F 196,164,132
C 73,216,230

111111111111111111
100000000000000001
100000000000000001
100000000000000001
10000000N000000001
100000000000000001
100000000000000001
100000000000000001
111111111111111111